.........
..O......
....O....
.OO..OOO.
.........